000000000000000
000000000000000
001111111111100
001000001000000
001000001000000
001111001100000
001001000110000
001001000010000
000001000010000
000001110011110
000000010000010
000000010000010
000S11110000010
0000000000000F0
000000000000000
